If it's what's meant to be， then so be it.	如果这是命中注定的，那就这样吧。
Drove him to snapping	逼得他抓狂。
What's that supposed to mean?	那是什么意思？
I'd rather plummet to my death!	我宁愿摔死。
Do you mean that literally， or figuratively?	你的意思是字面上的，还是比喻？
Do you have an alibi?	你有不在场证明吗？
Let's not get ahead of ourselves...	我们不要操之过急。
Framed for a murder she didn't commit.	被诬陷为她没有犯下的谋杀案。
A seriously purple misunderstanding.	一个严重的紫色误会。
Make things easier for yourself	让事情对你来说更容易。
I've got butterflies in my stomach.	我心里七上八下。
In the back of our minds.	在我们的脑海里。
A looming presence of great maleficence.	巨大罪恶的隐现。
I'll have a whole row of people waiting to do my bidding.	我会有一大排人等着听我的命令。
The light at the end of the tunnel.	隧道尽头的光明。
That lousy principal needs to learn a lesson himself!	那个差劲的校长自己也需要吸取教训。
"i stand inside the crescent moon"	我站在月牙儿里面
That once sailed through the glowing mist"	曾经在炽热的薄雾中航行
Bypass the ignition by turning the dials	转动旋钮，绕过点火开关
Those capes are really scratchy.	那些披风真的很扎人。
But it sure beats being an impersonal hooded blob!	但这肯定比做一个没有人情味的戴着兜帽的人要好。
Time to claim what is rightfully yours.	是时候索取属于你的东西了。
It's time for you to revolt!	是你反抗的时候了
Let's tear down the golden walls of the upper class!	让我们拆掉上流社会的金墙。
Let's trample the thorns of inequity!	让我们践踏不平等的荆棘。
Slink out of here	偷偷溜出去。
She reached out to me.	她向我伸出了手。
No wonder my head hurts...	难怪我的头会痛。
Stuck in the past...	停留在过去。
I am so pissed right now!	我现在很生气。
Dig up dirt on other students	挖出其他学生的丑闻
The fruits of your labor?	你的劳动成果
That'll run me even more fagged.	那会让我更累的。
A secret nerd genius?	一个神秘的书呆子天才
Just stop whimpering like a lost puppy.	别再像迷路的小狗一样呜咽了。
Cut to the chase	开门见山
Pushed from the balcony?	从阳台上推下来的。
Cradling the town in a warm red embrace.	在温暖的红色怀抱中拥抱着小镇。
You scared the life out of me， pig!	你吓死我了，猪
There's a bit too much resemblance for it to be a coincidence，	相似之处太多了，不可能是巧合。
She had you totally whipped?	她彻底打败了你。
I've got a hunch about you!	我对你有预感。
Don't you have somewhere to be?	你没有地方可去吗？
Some kind of awkward ribbing?	某种尴尬的嘲弄。
What it's capable of.	它的能力。
The spine of a block of tofu	一块豆腐的脊骨
That stands to reason	这是有道理的。
Isn't this place a vibe?	这地方是不是很有气氛？
Now more than ever.	现在比以往任何时候都多。
Passed from father to son for benerations.	从父亲传给儿子。
She can be a real handful.	她真的很难对付。
One shudders at the thought.	一想到这个就不寒而栗。
Exceptionally charming and gienerous.	非常迷人和优雅。
It would only be a matter of time	这只是时间问题。
Someone must have tipped them off!	一定是有人给他们通风报信了。
Which makes her the prime suspect.	所以她是头号嫌疑人。
There's more to this than meets the eye.	这件事比表面上看起来的要复杂。
I'll get to the bottom of this.	我会查个水落石出的。
So is planting endence to frame an innocent person!	栽赃陷害一个无辜的人也是。
They'll jump to conclusions.	他们会妄下结论。
The hawk and the weasel	鹰和黄鼠狼
I didn't mean it like that.	我不是那个意思。
An axe wielding maniac on the run from the cops...	一个挥舞着斧头的疯子在躲避警察。
Who had shuffled off this mortal coil to meet their maker?	他们摆脱了尘世的烦恼去见造物主
It harrows the mind. terrifies the soul. scars you to your very core	它折磨人的心灵。 吓坏了灵魂。 你内心深处的伤痕。
This mystery has all the hallmarks of foul play...	这个谜具有犯规行为的所有特征。
Stuck in the track!	卡在轨道上
A rush of blood	一股热血
Trampling muddy feet over a perfectly clean floor?	用泥泞的双脚踩在干净的地板上
For over 150 years.	150多年来。
The very founding of the university.	这所大学的建立。
No one on duty	无人值班
Give it a go	试一试
We'll go on the count of three.	我们数到三就走。
Where'd we end up now?	我们现在到哪里去了？
Snap out of it	突然改变情绪， 重新振作起来， 改变， 振作起来
Let's make it a pinky swear!	让我们用小指发誓
Face reality for once!	这一次面对现实！
Your puny little mind，	你弱小的心灵
Turn the tide somehow	以某种方式扭转局势
Nostalgia is not my forte.	怀旧不是我的强项。
Don't get any funny ideas.	不要有任何可笑的想法。
I'll probably only find regrets and sorrows there， but it's worth a shot.	我可能只会在那里找到遗憾和悲伤，但值得一试。
But nothing too fancy!	但不要太花哨。
It's a bit too noisy and quite cramped.	有点太吵了，而且很拥挤。
It's starting to weigh on my morale.	这开始影响我的士气了。
I'll probably give a go at it myself，	我可能会亲自试一试。
All creatures deserve love and care.	所有的生物都应该得到爱和关怀。
He was probably just in a hurry!	他可能只是赶时间。
I'm counting on you to help me out...	我指望你来帮我。
Can you do me a solid?	你能帮我个忙吗？
Happy to make your acquaintance.	很高兴认识你。
I just didn't think i'd have to make new friends at my age.	我只是没想到在我这个年纪还得交新朋友。
I can get along with anyone， anywhere， any time.	我可以在任何时间、任何地点与任何人相处。